NO ./textures/NO.xpm
SO ./textures/SO.xpm
EA ./textures/EA.xpm
WE ./textures/WE.xpm



F 220,100,0
C 225,30,0

1111111111111111111111111111111111
1111111111111111000000000001
1000100100000000010000001111111111
1000010000000001000000001
1000000001111000000000001
1000000000100000000000001
1000000000000000000100001
100000000000001S000000001
1001000000000011100000001
1001000000000011100000001
1001000000000011100000001
1001000000000011100000001
1001000000000011100000001
10010000000000111000000011111111111111111
1001000000000011100000001
1001000000000011100000001
1001000000000011100000001
1001000000000011100000001
1001000000000011100000001
1001000000000011100000001
1001000000000011100000001
1001000000000011100000001
1001000000000011100000001
1001000000000011100000001
1001000000000011100000001
1001000000000011100000001
1001000000000011100000001
1001000000000011100000001
1001000000000011100000001
1001000000000011100000001
1001000000000011100000001
1001000000000011100000001
1001000000000010000000001
1111111111111111111111111